#######
#     #
# _ f #
#     #
#######