############
#      # f #
#   #  #   #
# _ #      #
############