###############
#-       123  #
# #####       #
#> +  ###EfE###
### ###E#####E#
# #>   +     >#
# ##### #######
#  -   >      #
### ######### #
#- >#       # #
# # # ##### # #
# # # #     # #
# # # ####### #
#_# #         #
###############