########
#   #f##
#_   ^E#
#   #E##
########