####################
#                  #
#  _            f  #
#                  #
####################