###################
#_ v   > v v < > v#
# # # # # # # # # #
#  > v   1   ^   2#
# # # # # # # # # #
#>     ^ < >   ^  #
# # # # # # # # # #
#v 3 <   v   4   <#
# # # # # # # # # #
#  v < >     < 5 v#
# # # # # # # # # #
#>   ^   >   6 ^  #
# # # # # # # # # #
#v <   ^ <   < v <#
# # # # # # # # # #
#>     7 ^ <   8  #
# # # # # # # # # #
#      >   ^   > f#
###################