#######
#_    #
#     #
#     #
#     #
#    f#
#######